{
    "а": "ь",
    "б": "й",
    "в": "г",
    "г": "ю",
    "ґ": "б",
    "д": "я",
    "е": "р",
    "є": "в",
    "ж": "т",
    "з": "и",
    "и": "с",
    "і": "ч",
    "ї": "ї",
    "й": "х",
    "к": "к",
    "л": "м",
    "м": "п",
    "н": "у",
    "о": "з",
    "п": "н",
    "р": "д",
    "с": "ж",
    "т": "і",
    "у": "ц",
    "ф": "ґ",
    "х": "е",
    "ц": "о",
    "ч": "щ",
    "ш": "є",
    "щ": "ш",
    "ь": "а",
    "ю": "ф",
    "я": "л",
    "А": "Ь",
    "Б": "Й",
    "В": "Г",
    "Г": "Ю",
    "Ґ": "Б",
    "Д": "Я",
    "Е": "Р",
    "Є": "В",
    "Ж": "Т",
    "З": "И",
    "И": "С",
    "І": "Ч",
    "Ї": "Ї",
    "Й": "Х",
    "К": "К",
    "Л": "М",
    "М": "П",
    "Н": "У",
    "О": "З",
    "П": "Н",
    "Р": "Д",
    "С": "Ж",
    "Т": "І",
    "У": "Ц",
    "Ф": "Ґ",
    "Х": "Е",
    "Ц": "О",
    "Ч": "Щ",
    "Ш": "Є",
    "Щ": "Ш",
    "Ь": "А",
    "Ю": "Ф",
    "Я": "Л"
}